8 8
1 1
WWWWWWWW
W      W
WWWWWWBW
W  W   W
W     WW
WBWWW  E
W      W
WWWWWWWW